[
    [1, 16, 14, 18, 1, 9, 12, 1, 1, 14],
    [11, 3, 3, 15, 1, 12, 10, 17, 12, 14],
    [5, 19, 20, 19, 15, 5, 20, 1, 4, 20],
    [18, 6, 4, 7, 20, 7, 4, 11, 7, 8],
    [9, 18, 19, 14, 6, 9, 7, 19, 6, 17],
    [8, 19, 16, 11, 6, 15, 8, 1, 5, 2],
    [9, 18, 6, 14, 9, 17, 17, 5, 18, 2],
    [11, 7, 11, 20, 10, 10, 10, 17, 6, 18],
    [17, 9, 6, 12, 19, 10, 1, 10, 20, 11],
    [17, 3, 10, 7, 14, 9, 7, 3, 2, 11]
]
